10
...o.o..o........o......o.....
.oo.o.......oo......oo......oo
................o.............
.........o.....o..o.o.oooo..o.
......o.......o..oo........o.o
........o.....o.o...o.o.o.oo..
o..o.....o.......o......oo....
o..............o.......ooo.oo.
o..o..oo......o..o.o..........
...........o..oo.......o.o....